"filename", "language", "C++", "CUDA C++", "Python", "comment", "blank", "total"
"d:\Projects\RNIC-Scheduler\src\dev\rdma\Rnic.py", "Python", 0, 0, 54, 24, 14, 92
"d:\Projects\RNIC-Scheduler\src\dev\rdma\SConscript", "Python", 0, 0, 26, 28, 11, 65
"d:\Projects\RNIC-Scheduler\src\dev\rdma\cqc_module.cc", "C++", 110, 0, 0, 11, 35, 156
"d:\Projects\RNIC-Scheduler\src\dev\rdma\desc_scheduler.cc", "C++", 502, 0, 0, 67, 37, 606
"d:\Projects\RNIC-Scheduler\src\dev\rdma\hangu_cache.cc", "C++", 60, 0, 0, 30, 17, 107
"d:\Projects\RNIC-Scheduler\src\dev\rdma\hangu_dma_engine.cc", "C++", 214, 0, 0, 34, 54, 302
"d:\Projects\RNIC-Scheduler\src\dev\rdma\hangu_driver.cc", "C++", 600, 0, 0, 115, 131, 846
"d:\Projects\RNIC-Scheduler\src\dev\rdma\hangu_driver.hh", "C++", 97, 0, 0, 68, 50, 215
"d:\Projects\RNIC-Scheduler\src\dev\rdma\hangu_rnic.cc", "C++", 442, 0, 0, 87, 106, 635
"d:\Projects\RNIC-Scheduler\src\dev\rdma\hangu_rnic.hh", "C++", 528, 0, 0, 367, 282, 1177
"d:\Projects\RNIC-Scheduler\src\dev\rdma\hangu_rnic_defs.hh", "C++", 586, 0, 0, 91, 98, 775
"d:\Projects\RNIC-Scheduler\src\dev\rdma\kfd_ioctl.h", "CUDA C++", 0, 134, 0, 62, 64, 260
"d:\Projects\RNIC-Scheduler\src\dev\rdma\mr_module.cc", "C++", 371, 0, 0, 66, 81, 518
"d:\Projects\RNIC-Scheduler\src\dev\rdma\pending_struct.cc", "C++", 111, 0, 0, 19, 28, 158
"d:\Projects\RNIC-Scheduler\src\dev\rdma\qpc_module.cc", "C++", 341, 0, 0, 38, 36, 415
"d:\Projects\RNIC-Scheduler\src\dev\rdma\rdma_engine.cc", "C++", 883, 0, 0, 359, 237, 1479
"d:\Projects\RNIC-Scheduler\src\dev\rdma\rdma_nic.cc", "C++", 102, 0, 0, 24, 23, 149
"d:\Projects\RNIC-Scheduler\src\dev\rdma\rdma_nic.hh", "C++", 38, 0, 0, 24, 11, 73
"d:\Projects\RNIC-Scheduler\src\dev\rdma\resc_cache.cc", "C++", 242, 0, 0, 104, 80, 426
"Total", "-", 5227, 134, 80, 1618, 1395, 8454